5 8
....AA.#
.######!
...BA*##
.#######
..B$...B