111111111111111
10101K0L0K01L11
10000010110L001
101011010101K11
1001000000100L1
110001111L11K11
100100000100001
110K110100K0011
10K1L0K10111L01
1010110L1K11101
1000LL110001011
1101100L01000L1
100001111L11L11
101100000KL0111
111111111111111
12 12 12 1 2
13 11 12 1 2
1

