111111111111111
10001010100KL01
1010K000001L1K1
1001L11L1KL1011
10101K110100001
1000000L0010111
101111111010001
1K0000K001L0101
1011L111L11L101
100010011001L01
101001000010011
1010111010010L1
1L11K1100K10111
1L00000010L0001
111111111111111
10 7 1 13 2
11 8 1 13 2
1