111111111111111
10L000010111111
1011101KL0111L1
100K101011011K1
11010100000K1L1
100000011K101L1
11011L101L10001
10001010001K101
1K101K10101L101
1100100100011L1
100100101100011
11011L000011111
101000101000L11
10001010K1L1001
111111111111111
12 12 2 1 2
13 9 2 1 2
1

