11111111111111111111
1001LK0L0K0000L01001
101110110011001K11L1
100110001100111001L1
110000100001L1100001
11011010110000001011
1001101011011010K1L1
101L0K10001001L01001
1K01100101101LK10K11
11L1010K10L001L10101
10000K0101101L100KL1
10101100000K00K01111
1K101K10101L1K1L0001
11110000010001101011
101011010L1K11L11001
100000K1011000KL0101
10101101010011101001
10L1000L111000010101
10111010010011L00011
11111111111111111111
13 8 2 17 2
18 3 2 17 2
2