11111111111111111111
10001100K00011000001
1L1001K0101000101011
1001000010011K010001
10111L01001001L10101
10001100000010000001
11000010K101K1010101
1001100K0L1K00K100K1
101001KL111101LK1011
10L10101L1100110K111
10100K00000010001L11
1K11L1010101K0100KL1
11010101101001L01011
10001K1000010101K001
10100011010001011001
1K101000010100100001
101L0101010010010011
10L110001K0101010111
101L0010010001000111
11111111111111111111
2 9 3 18 2
1 2 3 18 2
2
