11111111111111111111
1K110110000010L00001
1000000K111000101101
10101110000111010011
1L1000K1010000000101
10101100100110110001
101L01L1K10010001101
10010100010101K11001
110101011000001001K1
1110K010010110001L01
110010000000010101K1
10010011101110010111
101K01L1010KL10K0001
101001K001L1000111L1
100001L10L10K1111101
10111L0K101011111101
101111L1101LK1001001
1000100K010K11010101
100K11L1000000000001
11111111111111111111
5 15 1 4 2
6 14 1 4 2
2
