111111111111111111111111111111
11L0001000110K10001000000K0001
100010K1010K000101010110111011
1001L100000110K000000100K01001
10111001010100001K101K10100001
1011110111K0010000100010001111
1011110000110001101011K1000101
1011111010010110010000010101L1
10111100010100010011K1001000K1
1000011K1001101100000010001111
10101111110000L0011101K01000K1
10L00111110101101LK00010K1K1L1
10110KL10100010011L10100100011
100101K00101001001100K10010101
1K1LK1110011001K10L10100100001
1L1100001000010000101001010111
11L100100100100101KL11010001L1
100101L010011K10110111010100K1
1100K0101100K0000L0K1LK1011001
110110K10010110110100101100011
1K10100001000010011100000101K1
10101K10L010110100101011000001
1LK0011011L1K10010001010110101
1111010K100L000101100000010011
10000L01K010110000111111000101
1110101L0L100L1010000000010101
1LK1K01K011111K1011010101000L1
1100L1101010000L000K1010110101
1LK11L00001011K101010010001001
111111111111111111111111111111
9 25 2 1 3
13 25 2 1 3
3