111111111111111111111111111111
100001K0010011K1001K1000000K11
101110101010000001000101011101
1LK000001000101101011L10000001
111011010101011011001000101101
10000100000000000001K01K100101
11K1010110101010111L0101010011
10L1K0100101001000001000001001
1100101L110L10110110001K1K1011
1001L00K000111L0KLK1K1KL110001
11001101101L1L101K110L11010101
111010001L00LL10100011L1L10101
1L1K101010101100110101K000K001
1KL111111111101100000101K1L111
101010110000001001110K0L01KL01
10000000011010K1110K00101K0101
101K10101000011L10010K000101K1
1001L10101K1000K0010001K01L1L1
1100K1010010010101K11001K01101
10010000000101010000K10000K011
101110101K00010010100000001L11
100010K01L1010011001110K111101
101100110100101101011000000001
101100000K01000000001101010111
100011101010K10110111000100001
1011000K1010100110000000K11011
10100011L01L010001010000001KL1
100L10100100101K100000000K01L1
10100111KL1000010010100001L101
111111111111111111111111111111
12 11 28 27 3
11 10 28 27 3
3