111111111111111111111111111111
100000K10000101000100000000001
100L1011011000001000111K10K101
1001K0100K10110110101111011001
100000001L1000100100K111000101
11110101001011010001L01K001001
110001011K10000001101KL1101101
10010K100011010100000110100001
101001001000100101K10000K01K11
111101010K101101L01K1011L10001
101110100100001110100000111011
1L111L001001K00111K10101K10001
10K00001001L100010001001011101
1K1111100L0K001000K010000001L1
100001K01011K10101L1001K101001
1L1011101000100L10K00101111001
10101101010101010011000K1K0001
1K01000L0010000001110010001001
1100010101001010111001L0100001
1K0100110K011110101K1L11L10101
1010010L1L1L101100100000110001
1LK1001010101L000100111K111101
110K1K000100001101011001111001
10011011101L110K10000011111101
11000000000001010K100111111K01
101010110101000001111111111101
1000100K1K01101011111111111L01
111011110111111111111111111111
100000000111111111111111111111
111111111111111111111111111111
27 26 3 2 3
11 20 3 2 3
3

