1 1
7 7
#############
#           #
########### #
###       # #
### ##### # #
### #   # # #
### # # # # #
### # # # # #
### # ### # #
### #     # #
### ####### #
###         #
#############