1 1
5 5
###########################
#                         #
######################### #
###                     # #
### ################### # #
### #                   # #
### ##################### #
###                       #
###########################