###############################
#S           #                #
#            #                #
#   ##########                #
#       #                     #
#       #                     #
#       #        ##############
#       #        #      #     #
#       #           #      #  #
#       #        ###########  #
#       #        #            #
#       #        #    #########
#                #            #
#                ##########   #
#                #            #
#                #           T#
###############################
